----------------------z-x---------------------
----------------------z-x---------------------
----------------------z-x---------------------
----------------------z-x---------------------
----------------------z-x---------------------
-----------ooooooooooooooooooooooo------------
-----------o----------o----------o------------
-----------o----------o----------o------------
-----------o----------o----------o------------
-----------o----------o----------o------------
-----------p----------p----------p------------
-----------p----------p----------p------------
-----------p----------p----------p------------
-----------o----------o----------o------------
-----------o----------o----------o------------
-----------o----------o----------o------------
-----------o----------o----------o------------
-----------ooooooooooooooooooooooo------------
--------------------z-x-----------------------
--------------------z-x-----------------------
--------------------z-x-----------------------
--------------------z-x-----------------------
--------------------z-x-----------------------
--------------------z-x-----------------------